%%%%%%%%%%%%%%%%%%%%%%%%%%%%%
%%%%......%%%%....%%%%....%%%
%......G...................G%
%%%.%%%%%.%.%.%.%.%.%.%%%%%.%
%...........................%
%%%.%%%%%.%.%.%.%.%.%.%%%%%.%
%...........................%
%%%%P.....%%%%....%%%%....%%%
%%%%%%%%%%%%%%%%%%%%%%%%%%%%%