%%%%%%%%%
%P .   G%
% %.%.% %
%..   ..%
%G%.o.%G%
%%%%%%%%%
