%%%%%%%%
%  P  G%
% %%%%%%
%G.... %
%%%%%%%%
